S,X,X,X,X,X,X,X,X,X,X
S,C,X,X,X,X,X,X,X,X,X
S,C,V,X,X,X,X,X,X,X,X
S,C,V,Z,X,X,X,X,X,X,X
S,C,V,Z,R,X,X,X,X,X,X
S,C,V,Z,R,S,X,X,X,X,X
S,C,V,Z,R,S,C,X,X,X,X
S,C,V,Z,R,S,C,V,X,X,X
S,C,V,Z,R,S,C,V,Z,X,X
S,C,V,Z,R,S,C,V,Z,R,X
P,P,P,P,P,P,P,P,P,P,S
