R,R,R,R,X,X,X,X,X,X,X
R,X,X,R,X,X,X,X,X,X,X
R,R,R,R,P,P,P,X,P,P,P
R,X,X,X,P,X,P,X,P,X,P
R,X,X,X,P,P,P,X,P,P,P