P,P,P,Z,Z,Z,Z,Z,Z,Z,Z
P,X,P,Z,Z,Z,Z,Z,Z,Z,Z
P,P,P,Z,P,P,P,Z,P,P,P
P,Z,Z,Z,P,X,P,Z,P,X,P
P,Z,Z,Z,P,P,P,Z,P,P,P
Z,Z,Z,Z,Z,Z,Z,Z,Z,Z,Z
Z,Z,Z,Z,Z,Z,Z,Z,Z,Z,Z
Z,Z,Z,Z,Z,Z,Z,Z,Z,Z,Z