R,P,P,P,P,P,P,P,P,R
D,X,X,X,X,X,X,X,X,D
Z,Z,Z,Z,Z,Z,Z,Z,Z,Z
X,X,X,X,X,X,X,X,X,X
N,P,P,P,P,P,P,P,P,N
D,X,X,X,X,X,X,X,X,D
Z,Z,Z,Z,Z,Z,Z,Z,Z,Z
X,X,X,X,X,X,X,X,X,X
Z,P,P,P,P,P,P,P,P,Z
D,X,X,X,X,X,X,X,X,D
R,R,R,R,R,R,R,R,R,R
X,X,X,X,X,X,X,X,X,X
R,R,R,R,R,R,R,R,R,R
D,X,X,X,X,X,X,X,X,D